Gạo tẻ	Kg
Vừng, lạc	Kg
Dầu, mỡ ăn	Lít
Nước mắm loại 1	Lít
Dầu rửa DCCD	Lít
Trứng vịt	Kg
Đậu phụ	Kg
Thịt bò 	Kg
Cá chim	kg
Tôm đầm	kg
Thịt vịt	kg
Chả lợn	kg
Thịt lợn mông	kg
Thịt lợn vai	kg
Thịt lợn ba chi	kg
Cua,ngao	kg
Mướp đắng	kg
Cà chua	kg
Hành lá	kg
Ớt tươi	kg
Gừng 	kg
Tỏi	kg
Hành khô	kg
Rau mùng tơi	kg
Chuối	kg
Ổi 	kg
Bắp cải	kg
Thịt bò loại 2	kg
Đường trắng	kg
Mực tươi	kg
Khay xốp dùng 1 lần	bộ
Sữa tươi 180mmml	Hộp
Thịt gà loại 1	Kg
Cá rô phi	kg
Cá chép	kg
Giò nạc	kg
Rau ngót	kg
Dưa chua	kg
Tim lợn	kg
Dưa hấu	kg
Me chua	kg
 Đỗ cô ve	kg
Thịt lợn nạc	Kg
Cá mè	kg
Cá biển	kg
Rau muống	kg
Miến	kg
Mộc nhĩ	kg
Đa nem	kg
Riềng	kg
Thịt bê	kg
Trứng vịt lộn	Kg
